1 0 0 0 1 0 0 0 0 0
2 0 0 0 0 0 0 0 0 0
3 0 1 1 1 1 1 1 1 1
4 0 2 2 2 2 2 2 2 2
5 0 3 3 3 3 3 3 3 3
6 0 2 2 2 2 2 2 2 2
7 0 1 1 0 1 1 1 1 1
8 0 0 0 0 0 0 0 0 0
8 0 0 0 0 0 0 0 0 0
8 0 0 0 0 0 0 0 0 0
8 0 0 0 0 0 0 0 0 0
8 0 0 0 0 0 0 0 0 0
8 0 0 0 0 0 0 0 0 0
8 0 0 0 0 0 0 0 0 0
8 0 0 0 0 0 0 0 0 0
